abstraction	абстракция
abstractions	абстракции
abstracts	рефераты
accepted	принятый
access	доступ
achieve	достигать
achieved	достигнутый
acquiring	приобретение
action	действие
actions	действия
addition	дополнение
address	адрес
advantage	преимущество
advice	совет
against	против
agement	равления
allows	позволяет
almost	почти
although	хотя
angles	углы
animated	анимационный
annotated	аннотированный
annotation	аннотация
annotations	аннотации
another	другой
apache	апаш
applets	апплеты
application	применение
applications	приложений
applying	применение
approach	подход
approaching	приближается
appropriate	соответствующий
aspect	аспект
aspects	аспекты
associating	связывая
assumes	предполагает
asynchronous	асинхронный
attack	атака
attempt	попытка
attribute	атрибут
authentication	идентификация
authority	власть
authorization	разрешение
automatically	автоматически
available	доступный
avoids	избегает
became	стал
because	потому
become	становиться
behavior	поведение
belief	вера
benefit	выгода
between	между
bility	ность
binary	двоичный
binding	обязательный
boiler	котел
boilerplate	шаблонный
brought	принес
browsers	браузеры
building	здание
builds	строит
bypassed	обошел
called	называемый
caller	гость
calling	призвание
capable	способный
cartoon	карикатура
categories	категории
cation	катион
central	центральный
centralize	централизовать
change	изменение
character	характер
characters	символы
choices	выбор
choose	выбирать
chosen	выбранный
claims	требования
classes	классы
cleaner	очиститель
client	клиент
closes	закрывается
cluding	числе
coding	кодирование
coming	приход
common	общий
commonly	обычно
community	сообщество
comparable	сравнимый
compilation	сборник
compile	компилировать
complete	полный
complex	комплекс
complexity	сложность
compli	следующ
compliant	уступчивый
complicate	усложнять
complicated	сложный
complying	соблюдение
component	компонент
components	компоненты
composed	состоит
comprehen	всесторонни
computing	вычисления
concerned	обеспокоенный
concerns	проблемы
condition	состояние
configuration	конфигурация
configure	конфигурировать
configured	сконфигурирован
configuring	настройке
connect	подключать
connection	подключение
consist	состоять
consistent	последовательный
constituent	составной
constructors	конструкторы
consumer	потребитель
consumption	потребление
contain	содержать
container	контейнер
context	контекст
continue	продолжать
contrary	вопреки
control	контроль
controlled	контролируемый
controller	контроллер
controllers	контроллеры
conven	Конвен
convenient	удобный
convert	конвертировать
coupled	соединенный
coupling	связь
create	создать
created	созданный
creates	создает
creating	создания
criticize	критиковать
critics	критики
customize	настроить
cutting	резка
database	база
december	декабрь
decided	решил
decision	решение
declaration	декларация
declarative	декларативный
declared	объявленный
deficiencies	недостатки
defined	определенный
defines	определяет
defining	определяющий
definition	определение
definitions	определения
delegating	делегирование
delete	удалять
depend	зависеть
dependencies	зависимости
dependency	зависимость
dependent	зависимый
deployment	развертывание
describe	описывать
described	описано
design	дизайн
designed	предназначенный
despite	несмотря
detecting	обнаружения
develop	развивать
developers	разработчиков
developing	развивающийся
development	развитие
development?	развитие
different	другой
directly	непосредственно
directs	направляет
disenchanted	Разочарованная
distributed	распределенный
dynamic	динамический
easier	полегче
easily	легко
ecosystem	экосистема
effectively	фактически
elements	элементы
emphasizing	выделение
employing	используя
employs	работает
enabled	включен
enables	позволяет
enriched	обогащенный
ensures	Обеспечивает
entered	вошли
enterprise	предприятие
environ	среда
established	установленный
evolved	эволюционировали
example	пример
except	кроме
exception	исключение
exceptions	исключения
exciting	захватывающий
execute	выполнять
execution	выполнение
expected	ожидаемый
expert	эксперт
explanation	объяснение
extend	продлить
extended	расширенный
extending	простирающийся
extension	расширение
external	внешний
facilitate	способствовать
factory	завод
failure	отказ
fairness	справедливость
feature	особенность
features	особенности
figure	фигура
figured	фигурный
filters	фильтры
flexible	гибкий
flocked	стекались
focused	сосредоточены
following	после
foundational	основополагающим
framework	рамки
frameworks	рамки
functionality	функциональность
functions	функции
fundamental	основной
furnish	отделка
further	дальше
general	генеральный
giving	дающий
glimpse	проблеск
gramming	мирования
greater	большой
greatly	значительно
handful	горсть
handle	обрабатывать
handled	обрабатываются
handler	обработчик
handling	обработка
happens	происходит
hibernate	зимовать
hierarchy	иерархия
however	однако
hundreds	сотни
illustrated	иллюстрированный
imagine	вообразить
implement	осуществлять
implementation	реализация
implementations	реализации
implemented	реализован
important	важно
inbound	входящий
includes	включает
incoming	входящий
indication	индикация
information	информация
initialization	инициализация
injected	введенный
injection	впрыск
inside	внутри
insight	понимание
instead	вместо
insufficient	недостаточное
intact	неповрежденный
integrates	интегрирует
integration	интеграция
intended	предназначена
interception	перехват
interface	интерфейс
interfaces	интерфейсы
internal	внутренний
internally	внутренне
intrusive	навязчивый
invasive	агрессивный
inversion	инверсия
invocation	вызов
invocations	вызовы
invoke	вызывать
invoked	вызывается
involves	включает
isting	статки
jakarta	Джакарта
johnson	Джонсон
juggling	жонглирование
language	язык
latest	последний
layers	слои
learned	ученый
leaving	уход
library	библиотека
lifecycles	Жизненный
lightweight	легкий
likely	вероятно
limited	ограниченное
listed	перечислены
littering	замусоривание
little	немного
loading	загрузка
locale	место
logical	логический
longer	дольше
lookup	искать
loosely	свободно
maintain	поддерживать
manage	управлять
managed	удалось
management	управление
managing	управления
mandating	обязательное
mapping	отображение
mcconnell	Макконнелл
meaningful	смысл
mechanism	механизм
message	сообщение
messages	сообщения
messaging	обмен
method	метод
methods	методы
microsystems	микросистемы
minimally	минимально
mission	миссия
mistake	ошибка
models	модели
modern	современный
modularizes	модуляризирует
module	модуль
modules	модули
motivation	мотивация
namespace	имен
namespaces	Пространства
nection	СОЕДИН
needed	необходимый
normally	обычно
notation	обозначение
notion	понятие
object	объект
objects	объекты
obtain	получать
obtained	полученный
offered	предложенный
offering	предложение
offers	предложения
ongoing	постоянный
optional	необязательный
optionally	опционально
options	опции
oriented	ориентированного
original	оригинал
originally	первоначально
others	другие
overall	общий
paradigm	парадигма
parameterized	параметризованная
partially	частично
participation	участие
particular	особый
passed	прошло
passes	проходит
pattern	шаблон
pendency	нерешенность
perceived	воспринимается
performed	выполняется
persistence	настойчивость
phases	фазы
picking	сбор
picture	картина
pitchfork	вилы
planned	планируемый
platform	платформа
plexity	сложность
plication	пликация
plumbing	водопровод
points	пунктов
policies	полисы
popular	популярный
popularity	популярность
portlet	портлета
possible	возможный
powerful	мощный
predecessors	предшественники
prefer	предпочитать
presentation	презентация
prevents	предотвращает
previously	предварительно
primary	основной
principal	главный
problem	проблема
problems	проблемы
procedure	процедура
processes	процессы
program	программа
programming	программирование
project	проект
projects	проекты
promote	содействовать
promotes	способствует
proper	правильный
properties	свойства
provide	предоставить
provides	обеспечивает
providing	обеспечение
proxying	прокси
public	общественное
published	опубликованный
purpose	цель
quired	потребовавшие
rather	довольно
ration	рацион
reaction	реакция
reasonable	разумный
recent	последний
recipes	рецепты
redirect	переориентировать
reduction	сокращение
reflection	отражение
related	связанный
relational	реляционный
release	релиз
releasing	выпускать
remain	оставаться
reminiscent	напоминающий
remote	удаленный
remoting	удаленного
removes	удаляет
rendering	оказание
represen	представи
representation	представление
representational	репрезентативный
represented	представленный
request	запрос
requests	запросы
require	требовать
required	требуется
requires	требуется
resemblance	сходство
reserved	зарезервированный
resolvers	преобразователи
resolving	решения
resort	курорт
resource	ресурс
resources	ресурсы
response	ответ
responsibilities	обязанности
responsibility	ответственность
responsible	ответственный
restrict	ограничивать
result	результат
results	результаты
returned	возвращенный
returning	возврате
reusable	многоразовый
reused	повторно
runtime	время
saving	экономия
scattered	рассеянный
scenic	сценический
scheduling	планирование
secure	обеспечивать
secured	обеспеченный
security	безопасность
seemed	казалось
selecting	выбирающий
sented	излагаемого
separate	отдельный
separating	разделяющий
server	сервер
servers	серверы
service	служба
services	услуги
servlet	сервлет
several	несколько
shortage	нехватка
should	должен
significantly	существенно
simple	простой
simpler	проще
simplicity	простота
simplifies	упрощает
simplify	упростить
simplifying	упрощение
slimmed	похудела
software	программное
solution	решение
solutions	решения
sophisticated	сложный
source	источник
sources	источники
special	специальный
specific	удельный
specification	спецификация
spring	весна
standards	стандарты
started	начал
statement	заявление
states	состояния
stayed	остался
straight	прямо
strange	странный
strategies	стратегии
strategy	стратегия
strictly	строго
string	строка
struts	стойки
subject	тема
submit	представлять
successful	успешный
succinctly	кратко
suffice	достаточно
suited	подходящий
superficial	поверхностный
supplies	принадлежностей
support	поддержка
supported	поддержанный
supports	опоры
switches	переключатели
tapestry	гобелен
tational	ционно
tations	ставления
techniques	методы
template	шаблон
testability	проверяемость
testing	тестирование
themselves	сами
therefore	поэтому
things	вещи
thinking	мышление
though	хотя
through	через
tightly	плотно
together	вместе
traced	проследить
transaction	сделка
transactions	операции
transfer	перевод
transferring	передачи
transition	переход
transitions	переходы
translating	перевод
translation	перевод
transparent	прозрачный
troduced	введенная
turned	оказалось
typical	типичный
understand	понять
unwieldy	громоздкий
unwrapping	разворачивая
uploads	добавления
usefulness	полезность
vanilla	ваниль
variable	переменная
variations	изменения
variety	разнообразие
various	различный
vendors	поставщики
ventional	обычными
version	версия
verter	преобразователь
vidual	дельных
virtually	фактически
wanted	хотел
weaving	ткачество
whatever	неважно
widgets	Виджеты
wiring	электропроводка
working	работа
wrappers	обертки
wrapping	упаковка
writing	письмо
yourself	себя
